{
  "tileSize": 1,
  "grid": [
    ["W", "W", "W", "W", "W", "W", "W", "W"],
    ["W", "S", "I", "I", "I", "I", "I", "W"],
    ["W", "I", "I", "W", "I", "I", "I", "W"],
    ["W", "I", "I", "I", "I", "I", "I", "W"],
    ["W", "I", "I", "I", "I", "I", "E", "W"],
    ["W", "W", "W", "W", "W", "W", "W", "W"]
  ]
}
